campaignLevels: {
        1:
        [
            "................................................................................................................................................................................................................................................................................................................................",
            "................................................................................................................................................................................................................................................................................................................................",
            ".....................................................?K?........................................................................................................................................................................................................................................................................",
            "................................................................................................................................................................................................................................................................................................................................",
            "................................................................................................................................................................................................................................................................................................................................",
            "...............................................SSS..............................................................................................................................................................................................................................................................................",
            "................................................................................................................................................................................................................................................................................................................................",
            "....C...C....C...........................................................................C...C...C........................................................................C...C....C...........................................................................C...C...C........................................................",
            ".....C.C..C.C............................SSS..............................................C.C.C.C..........................................................................C.C..C.C.............................................................................C.C.C.C.........................................................",
            "......C....C...............................................................................C...C............................................................................C....C...............................................................................C...C..........................................................",
            "................................................................................................................................................................................................................................................................................................................................",
            ".............................?B?...SSS........................T.....................................................................T..............................................................?B?..............................T.....................................................................T.....................",
            "....1....M.........S.S.S....................T........S.S.S....2....................M.............................................SSSt..........................................M.........S.S.S....................T........S.S.S....2....................M.............................................SSSt........................g",
            "...................SSSSS....................t........SSSSS....t..................................................................SSSt..........................SSSSSSS...................SSSSS....................t........SSSSS....t..................................................................SSSt..........................SSSSSSS",
            "SSSSSSSSSSSSSSSSSSSSSSSSSSSLLSSSSSSSSSSSSSSStSSSSSSSSSSSSSSSSStSSSSSSSSSSSSSSSSSSSSLLSSSSSSSSSSSSSSSSSSSSSSSSSSLLSSSSSSSSSSSSStSSSSSSSSSSSSSSSSSSSSSSSSSSSSSSSSSSSSSSSSSSSSSSSSSSSSSSSSSSSSLLSSSSSSSSSSSSSSStSSSSSSSSSSSSSSSSStSSSSSSSSSSSSSSSSSSSSLLSSSSSSSSSSSSSSSSSSSSSSSSSSLLSSSSSSSSSSSSStSSSSSSSSSSSSSSSSSSSSSSSSSSSSSSSSS"
        ],
        2:
        [
            "................................................................................................................................................................................................................................................................................................................................",
            "................................................................................................................................................................................................................................................................................................................................",
            ".....................................................?K?........................................................................................................................................................................................................................................................................",
            ".......................................O...............................O.................................................................................................................................O...............................O......................................................................................",
            "......................................SSS.............................SSS...............................................................................................................................SSS.............................SSS.....................................................................................",
            ".......BKB.....................................SSS..c.......................................c........................O...................................................BKB..........................................c.......................................c........................O........................................",
            "......C...C.......c................................SSS.....................................SSS......................SSS.................................................C...C.......c................................SSS.....................................SSS......................SSS.......................................",
            "......C...C......SSS....................................................................................................................................................C...C......SSS..........................................................................................................................................",
            ".........................................SSS....C.C...............................................................................................................................................................C.C...........................................................................................................",
            "................................................C.C...............................................................................................................................................................C.C...........................................................................................................",
            "...............X.................................................................................................................................................................X..............................................................................................................................................",
            "............S.S.S..................SSS...................T.......................................T...................................T........................................S.S.S...................5....................T.......................................T...................................T........................",
            "....1.......S.S.S...............4...S........O...........t........S...........X............O.....t....................C.C.C.C........t........................................S.S.S...............4...S........O...........t........S...........X............O.....t....................C.C.C.C........t...................g....",
            "....S..WW...SSSSS...WW..........WW..S.......SSS...WW.....t...WW...S....WW...S.S.S...WW....SSS....t...WW...............C.C.C.C........t..................SSS...........S..WW...SSSSS...WW..........WW..S.......SSS...WW.....t...WW...S....WW...S.S.S...WW....SSS....t...WW...............C.C.C.C........t..................SSS...",
            "SSSSSSWWWWSSSSSSSSSWWWWSSSSSSSSTTWWWSWWWWSSSSSSSSWWWWSSSStWWWWWWWWSWWWWWWWWSSSSSSSSTTWWWWWWWWWWWStWWWWWWWWWWSSSSSSSSSSSSSSSSSSSSSSSSStSSSSSSSSSSSSSSSSSSSSSSSSSSSSSSSSSSWWWWSSSSSSSSSWWWWSSSSSSSSTTWWWSWWWWSSSSSSSSWWWWSSSStWWWWWWWWSWWWWWWWWSSSSSSSSTTWWWWWWWWWWWStWWWWWWWWWWSSSSSSSSSSSSSSSSSSSSSSSSStSSSSSSSSSSSSSSSSSSSSSSSSSSSS"
        ],
        3:
        [
            "................................................................................................................................................................................................................................................................................................................................",
            "................................................................................................................................................................................................................................................................................................................................",
            "............................................K...................................................................................................................................................................................................................................................................................",
            ".........................................................................................................................................................................................A........................A........................A........................A........................A..................................",
            "..............................................................................................................................................................................................V........................V........................V........................V........................V.............................",
            "...........................................SSS..................................................................................................................................................................................................................................................................................",
            "................................................................................................................................................................................................................................................................................................................................",
            ".......................................SSS....................................................................................................................PPPPP........................................................................SSSSS................................................................................",
            "........................................................................................................SSS..............................................................................H.................H.................H.................H.................H.................H.................H........HH................",
            "......SSS..........................SSS....................PPPP....................SSS..........................................CC........................................................H.................H.................HSSSS.............H.................H.................H.................H........HH................",
            "................................................PPPP........................................................................p.PPPP...............PPPPP....................PPPPP..........H........p........H.................H.................H.................H.................H.................H........HH................",
            ".................SSS....SSS....SSS......................................BB?BB..................SSS...............SSS........T.....BB?BB..................................................FBB?BB...T........F......SSSS.......F.................F.................F.................F.................F........HH................",
            "....1.......................................................................................................................t.....................................................................t...............c..................................c..................................c....E.............HH......g.........",
            ".......F......................................................................MMM..F........................................t.......................................................F.OMMO.MM.....tF....O...OR....c....O.MM.R....FO...R.MM.O....F....c.MO.O....R....F....O....O....F.MM.c...........OM........HH................",
            "SSSSSSSSSSSSSSSLLLLLLLLLLLLLLLSSSSSSSSSSSSSSSLLLLLLLLLLLLLLLLLLLLLLLLLSSSSSSSSSSSSSSSSSSSSLLLLLLLLLLLLLLLLLLLLLLLLLLLLLLSSSSSSSSSSSSSSSSSSSSLLLLLLLLLLLLLLLLLLLLLLLLLLLLLLLLLLLLLLLLLLLLSSSSSSSSSSSSSSSSLLLLSSSSSSSSSSSSSSSSLLLLSSSSSSSSSSSSSSSSLLLLSSSSSSSSSSSSSSSSLLLLSSSSSSSSSSSSSSSSSSSSSSSSSSSSSSSSSSSSSSSSSSSSSSSSSSSSSSSS"
        ]
    },