campaignLevels: {
        1:
        [
            "................................................................................................................................................................................................................................................................................................................................",
            "................................................................................................................................................................................................................................................................................................................................",
            ".....................................................?K?........................................................................................................................................................................................................................................................................",
            "................................................................................................................................................................................................................................................................................................................................",
            "................................................................................................................................................................................................................................................................................................................................",
            "...............................................SSS..............................................................................................................................................................................................................................................................................",
            "................................................................................................................................................................................................................................................................................................................................",
            "....C...C....C...........................................................................C...C...C........................................................................C...C....C...........................................................................C...C...C........................................................",
            ".....C.C..C.C............................SSS..............................................C.C.C.C..........................................................................C.C..C.C.............................................................................C.C.C.C.........................................................",
            "......C....C...............................................................................C...C............................................................................C....C...............................................................................C...C..........................................................",
            "................................................................................................................................................................................................................................................................................................................................",
            ".............................?B?...SSS........................T.....................................................................T..............................................................?B?..............................T.....................................................................T.....................",
            "....1....M.........S.S.S....................T........S.S.S....2....................M.............................................SSSt..........................................M.........S.S.S....................T........S.S.S....2....................M.............................................SSSt........................g",
            "...................SSSSS....................t........SSSSS....t..................................................................SSSt..........................SSSSSSS...................SSSSS....................t........SSSSS....t..................................................................SSSt..........................SSSSSSS",
            "SSSSSSSSSSSSSSSSSSSSSSSSSSSLLSSSSSSSSSSSSSSStSSSSSSSSSSSSSSSSStSSSSSSSSSSSSSSSSSSSSLLSSSSSSSSSSSSSSSSSSSSSSSSSSLLSSSSSSSSSSSSStSSSSSSSSSSSSSSSSSSSSSSSSSSSSSSSSSSSSSSSSSSSSSSSSSSSSSSSSSSSSLLSSSSSSSSSSSSSSStSSSSSSSSSSSSSSSSStSSSSSSSSSSSSSSSSSSSSLLSSSSSSSSSSSSSSSSSSSSSSSSSSLLSSSSSSSSSSSSStSSSSSSSSSSSSSSSSSSSSSSSSSSSSSSSSS"
        ],
        2:
        [
            "................................................................................................................................................................................................................................................................................................................................",
            "................................................................................................................................................................................................................................................................................................................................",
            ".....................................................?K?........................................................................................................................................................................................................................................................................",
            ".......................................O...............................O.................................................................................................................................O...............................O......................................................................................",
            "......................................SSS.............................SSS...............................................................................................................................SSS.............................SSS.....................................................................................",
            ".......BKB.....................................SSS..c.......................................c........................O...................................................BKB..........................................c.......................................c........................O........................................",
            "......C...C.......c................................SSS.....................................SSS......................SSS.................................................C...C.......c................................SSS.....................................SSS......................SSS.......................................",
            "......C...C......SSS....................................................................................................................................................C...C......SSS..........................................................................................................................................",
            ".........................................SSS....C.C...............................................................................................................................................................C.C...........................................................................................................",
            "................................................C.C...............................................................................................................................................................C.C...........................................................................................................",
            "...............X.................................................................................................................................................................X..............................................................................................................................................",
            "............S.S.S..................SSS...................T.......................................T...................................T........................................S.S.S...................5....................T.......................................T...................................T........................",
            "....1.......S.S.S...............4...S........O...........t........S...........X............O.....t....................C.C.C.C........t........................................S.S.S...............4...S........O...........t........S...........X............O.....t....................C.C.C.C........t...................g....",
            "....S..WW...SSSSS...WW..........WW..S.......SSS...WW.....t...WW...S....WW...S.S.S...WW....SSS....t...WW...............C.C.C.C........t..................SSS...........S..WW...SSSSS...WW..........WW..S.......SSS...WW.....t...WW...S....WW...S.S.S...WW....SSS....t...WW...............C.C.C.C........t..................SSS...",
            "SSSSSSWWWWSSSSSSSSSWWWWSSSSSSSSTTWWWSWWWWSSSSSSSSWWWWSSSStWWWWWWWWSWWWWWWWWSSSSSSSSTTWWWWWWWWWWWStWWWWWWWWWWSSSSSSSSSSSSSSSSSSSSSSSSStSSSSSSSSSSSSSSSSSSSSSSSSSSSSSSSSSSWWWWSSSSSSSSSWWWWSSSSSSSSTTWWWSWWWWSSSSSSSSWWWWSSSStWWWWWWWWSWWWWWWWWSSSSSSSSTTWWWWWWWWWWWStWWWWWWWWWWSSSSSSSSSSSSSSSSSSSSSSSSStSSSSSSSSSSSSSSSSSSSSSSSSSSSS"
        ],
        3:
        [
            "................................................................................................................................................................................................................................................................................................................................",
            "................................................................................................................................................................................................................................................................................................................................",
            ".....................................................?K?........................................................................................................................................................................................................................................................................",
            "..................................................C.C.............................................................................................................................................................C.C...........................................................................................................",
            ".................................................C...C...........................................................................................................................................................C...C..........................................................................................................",
            "........B?B....................................SSS....C.................................................................................................................B?B.....................................C.....C.........................................................................................................",
            ".......C...C...........................................................................................................................................................C...C....................................................................................................................................................",
            ".......C...C.................P.............E.............P.............................................................................................................C...C.................P.............E.............P......................................................................................................",
            "............................PPP..........SSS............PPP.................................................................................................................................PPP.........................PPP.....................................................................................................",
            "....................T......PPPPP.......................PPPPP........................................................................................................................T......PPPPP.......................PPPPP....................................................................................................",
            "....1...............t.....PPPPPPP.....................PPPPPPP..............C...C....................................................................................................t.....PPPPPPP.....................PPPPPPP..............C...C................................................................................",
            "....S.......M.......t....PPPPPPPPP.SSS...............PPPPPPPPP............C.....C...................................................................................S.......M.......t....PPPPPPPPP...................PPPPPPPPP............C.....C........................g......................................................",
            "....S..LL..SSS..LL..t...PPPPPPPPPPP.................PPPPPPPPPPP..........C.......C......................SSS.........................................................S..LL..SSS..LL..t...PPPPPPPPPPP.................PPPPPPPPPPP..........C.......C......................SSS.....................................................",
            "SSSSSSSLLSSSSSSSLLLLtSSPPPPPPPPPPPPPSSSSSSSSSSSSSSSPPPPPPPPPPPPPSSSSSSSSSLLLLLLLLLSSSSSSSSSSSSSSSSSSSSSSSSSSSSSSSSSSSSSSSSSSSSSSSSSSSSSSSSSSSSSSSSSSSSSSSSSSSSSSSSSSSSSLLSSSSSSSLLLLtSSPPPPPPPPPPPPPSSSSSSSSSSSSSSSPPPPPPPPPPPPPSSSSSSSSSLLLLLLLLLSSSSSSSSSSSSSSSSSSSSSSSSSSSSSSSSSSSSSSSSSSSSSSSSSSSSSSSSSSSSSSSSSSSSSSSSSSSSSS",
            "SSSSSSSLLSSSSSSSLLLLtSSPPPPPPPPPPPPPSSSSSSSSSSSSSSSPPPPPPPPPPPPPSSSSSSSSSLLLLLLLLLSSSSSSSSSSSSSSSSSSSSSSSSSSSSSSSSSSSSSSSSSSSSSSSSSSSSSSSSSSSSSSSSSSSSSSSSSSSSSSSSSSSSSLLSSSSSSSLLLLtSSPPPPPPPPPPPPPSSSSSSSSSSSSSSSPPPPPPPPPPPPPSSSSSSSSSLLLLLLLLLSSSSSSSSSSSSSSSSSSSSSSSSSSSSSSSSSSSSSSSSSSSSSSSSSSSSSSSSSSSSSSSSSSSSSSSSSSSSSS"
        ]
    },